########
###   ##
#   # ##
# #$ . #
#    # #
## #   #
##@  ###
########